"filename", "language", "Markdown", "C++", "Makefile", "comment", "blank", "total"
"/Users/rainchen/CodingSpace/Pineapple/README.md", "Markdown", 76, 0, 0, 0, 61, 137
"/Users/rainchen/CodingSpace/Pineapple/digiLibrary-CLI/Makefile", "Makefile", 0, 0, 45, 26, 21, 92
"/Users/rainchen/CodingSpace/Pineapple/digiLibrary-CLI/include/account.h", "C++", 0, 30, 0, 5, 6, 41
"/Users/rainchen/CodingSpace/Pineapple/digiLibrary-CLI/include/book.h", "C++", 0, 35, 0, 5, 6, 46
"/Users/rainchen/CodingSpace/Pineapple/digiLibrary-CLI/include/log4lib.h", "C++", 0, 12, 0, 5, 6, 23
"/Users/rainchen/CodingSpace/Pineapple/digiLibrary-CLI/include/usermode.h", "C++", 0, 12, 0, 5, 6, 23
"/Users/rainchen/CodingSpace/Pineapple/digiLibrary-CLI/include/welcome.h", "C++", 0, 15, 0, 6, 5, 26
"/Users/rainchen/CodingSpace/Pineapple/digiLibrary-CLI/src/account.cpp", "C++", 0, 212, 0, 16, 3, 231
"/Users/rainchen/CodingSpace/Pineapple/digiLibrary-CLI/src/book.cpp", "C++", 0, 357, 0, 41, 2, 400
"/Users/rainchen/CodingSpace/Pineapple/digiLibrary-CLI/src/log4lib.cpp", "C++", 0, 57, 0, 11, 2, 70
"/Users/rainchen/CodingSpace/Pineapple/digiLibrary-CLI/src/main.cpp", "C++", 0, 182, 0, 77, 2, 261
"/Users/rainchen/CodingSpace/Pineapple/digiLibrary-CLI/src/usermode.cpp", "C++", 0, 17, 0, 6, 2, 25
"/Users/rainchen/CodingSpace/Pineapple/digiLibrary-CLI/src/welcome.cpp", "C++", 0, 14, 0, 5, 2, 21
"Total", "-", 76, 943, 45, 208, 124, 1396