"filename", "language", "C++", "Markdown", "Makefile", "comment", "blank", "total"
"/Users/rainchen/CodingSpace/Pineapple/README.md", "Markdown", 0, 70, 0, 0, 56, 126
"/Users/rainchen/CodingSpace/Pineapple/digiLibrary-CLI/Makefile", "Makefile", 0, 0, 45, 26, 21, 92
"/Users/rainchen/CodingSpace/Pineapple/digiLibrary-CLI/include/commandn.hpp", "C++", 23, 0, 0, 9, 4, 36
"/Users/rainchen/CodingSpace/Pineapple/digiLibrary-CLI/include/commands.hpp", "C++", 23, 0, 0, 9, 4, 36
"/Users/rainchen/CodingSpace/Pineapple/digiLibrary-CLI/include/countline.hpp", "C++", 12, 0, 0, 7, 4, 23
"/Users/rainchen/CodingSpace/Pineapple/digiLibrary-CLI/include/log4me.hpp", "C++", 12, 0, 0, 7, 4, 23
"/Users/rainchen/CodingSpace/Pineapple/digiLibrary-CLI/include/welcome.hpp", "C++", 15, 0, 0, 7, 4, 26
"/Users/rainchen/CodingSpace/Pineapple/digiLibrary-CLI/src/commandn.cpp", "C++", 325, 0, 0, 17, 2, 344
"/Users/rainchen/CodingSpace/Pineapple/digiLibrary-CLI/src/commands.cpp", "C++", 431, 0, 0, 27, 3, 461
"/Users/rainchen/CodingSpace/Pineapple/digiLibrary-CLI/src/countline.cpp", "C++", 12, 0, 0, 7, 2, 21
"/Users/rainchen/CodingSpace/Pineapple/digiLibrary-CLI/src/log4me.cpp", "C++", 51, 0, 0, 13, 3, 67
"/Users/rainchen/CodingSpace/Pineapple/digiLibrary-CLI/src/main.cpp", "C++", 98, 0, 0, 22, 3, 123
"/Users/rainchen/CodingSpace/Pineapple/digiLibrary-CLI/src/welcome.cpp", "C++", 14, 0, 0, 6, 2, 22
"Total", "-", 1016, 70, 45, 157, 112, 1400