"filename", "language", "C++", "Makefile", "Markdown", "comment", "blank", "total"
"/Users/rainchen/CodingSpace/Pineapple/Library-cli-other/Makefile", "Makefile", 0, 45, 0, 26, 21, 92
"/Users/rainchen/CodingSpace/Pineapple/Library-cli-other/include/commandn.hpp", "C++", 20, 0, 0, 8, 8, 36
"/Users/rainchen/CodingSpace/Pineapple/Library-cli-other/include/commands.hpp", "C++", 20, 0, 0, 8, 8, 36
"/Users/rainchen/CodingSpace/Pineapple/Library-cli-other/include/countline.hpp", "C++", 8, 0, 0, 6, 6, 20
"/Users/rainchen/CodingSpace/Pineapple/Library-cli-other/include/log4me.hpp", "C++", 11, 0, 0, 7, 6, 24
"/Users/rainchen/CodingSpace/Pineapple/Library-cli-other/include/welcome.hpp", "C++", 11, 0, 0, 6, 6, 23
"/Users/rainchen/CodingSpace/Pineapple/Library-cli-other/src/commandn.cpp", "C++", 331, 0, 0, 13, 8, 352
"/Users/rainchen/CodingSpace/Pineapple/Library-cli-other/src/commands.cpp", "C++", 436, 0, 0, 24, 8, 468
"/Users/rainchen/CodingSpace/Pineapple/Library-cli-other/src/countline.cpp", "C++", 12, 0, 0, 6, 3, 21
"/Users/rainchen/CodingSpace/Pineapple/Library-cli-other/src/log4me.cpp", "C++", 51, 0, 0, 12, 8, 71
"/Users/rainchen/CodingSpace/Pineapple/Library-cli-other/src/main.cpp", "C++", 102, 0, 0, 22, 14, 138
"/Users/rainchen/CodingSpace/Pineapple/Library-cli-other/src/welcome.cpp", "C++", 15, 0, 0, 6, 2, 23
"/Users/rainchen/CodingSpace/Pineapple/Library-cli/include/commandn.hpp", "C++", 20, 0, 0, 8, 8, 36
"/Users/rainchen/CodingSpace/Pineapple/Library-cli/include/commands.hpp", "C++", 20, 0, 0, 8, 8, 36
"/Users/rainchen/CodingSpace/Pineapple/Library-cli/include/countline.hpp", "C++", 8, 0, 0, 6, 6, 20
"/Users/rainchen/CodingSpace/Pineapple/Library-cli/include/log4me.hpp", "C++", 11, 0, 0, 7, 6, 24
"/Users/rainchen/CodingSpace/Pineapple/Library-cli/include/welcome.hpp", "C++", 11, 0, 0, 6, 6, 23
"/Users/rainchen/CodingSpace/Pineapple/Library-cli/src/commandn.cpp", "C++", 330, 0, 0, 13, 8, 351
"/Users/rainchen/CodingSpace/Pineapple/Library-cli/src/commands.cpp", "C++", 436, 0, 0, 24, 8, 468
"/Users/rainchen/CodingSpace/Pineapple/Library-cli/src/countline.cpp", "C++", 12, 0, 0, 6, 3, 21
"/Users/rainchen/CodingSpace/Pineapple/Library-cli/src/log4me.cpp", "C++", 51, 0, 0, 12, 8, 71
"/Users/rainchen/CodingSpace/Pineapple/Library-cli/src/main.cpp", "C++", 102, 0, 0, 22, 14, 138
"/Users/rainchen/CodingSpace/Pineapple/Library-cli/src/welcome.cpp", "C++", 15, 0, 0, 6, 2, 23
"/Users/rainchen/CodingSpace/Pineapple/README.md", "Markdown", 0, 0, 61, 0, 50, 111
"Total", "-", 2033, 45, 61, 262, 225, 2626